1111111111111111111111
0033302003002000300031
1111111111111111111111
1002000000000000000000
1111111111111111111111
0030000003230030020001
1111111111111111111111
1002000000300300300000
1111111111111111111111
0330000200000203300001
1111111111111111111111
1002003030030034003000
1111111111111111111111
0043000400000440003001
0004400003000300400001
